111111111111111111111
1$0000000000000000001
100000000000000000001
100000000000000000001
100011110001111000001
100011110001111000001
100000000000000000001
100000000000000000001
100000000000000000001
100011110001111000001
100011110001111000001
100000000000000000001
100000000000000000001
100000000000000000001
100011111001111000001
111111111011111111111
100000000000000000001
100000000000000000001
100000000000000000001
1000000000000000000@1
111111111111111111111