111111111111111111111
100000000000000000001
100000000000000000001
100000000000000000001
100011110001111000001
100011110001111000001
100000000000000000001
100000000000000000001
100000000000000000001
100011110001111000001
100011110001111000001
100000000000000000001
10$000000000000@00001
100000000000000000001
100011110001111000001
100011110001111000001
100000000000000000001
100000000000000000001
100000000000000000001
100000000000000000001
111111111111111111111