111111111111111111111
100000000000000000001
1000000@0000000000001
100000000000000000001
100011110001111100001
100011110001111100001
100000000000000000001
100000000000000000001
100000000000000000001
100011110001111100001
100011110001111100001
100000000000000000001
100000000000000000001
100000000000000000001
100011110001111100001
100011110001111100001
10000000$000000000001
100000000000000000001
100000000000000000001
100000000000000000001
111111111111111111111