111111111111111111111
1000000000000000000@1
100000000000000000001
100000000000000000001
111111110111111111111
100011110001111000001
100000000000000000001
100000000000000000001
100000000000000000001
111111110111111111111
100011110001111000001
100000000000000000001
100000000000000000001
100000000000000000001
111111110111111111111
100011110001111000001
100000000000000000001
100000000000000000001
100000000000000000001
1$0000000000000000001
111111111111111111111