111111111111111111111
111111111111111111111
111111111111111111111
111111111111111111111
111111111111111111111
111111111111111111111
111111111111111111111
000000000000000000000
011110111101111011110
011110111101111011110
011110111101111011110
011110111101111011110
011110111101111$11110
0111101111@1111011110
011110111101111011110
011110111101111011110
011110111101111011110
000000000000000000000
111111111111111111111
111111111111111111111
111111111111111111111
